W W W W W W W W W W W W W W W W W W W W
W E e e e W e e e e e e e e W e e e P W
W e W W e W e W W W W W W e W e W W e W
W e W e e e e e e e e e e e e e e W e W
W e W e W W e W W e e W W e W W e W e W
W e e e e e e W G G G G W e e e e e e W
W e W e W W e W W W W W W e W W e W e W
W e W e e e e e e e e e e e e e e W e W
W e W W e W e W W W W W W e W e W W e W
W e e e e W e e e e e e e e W e e e E W
W e e W W W W W e e e e W W W W W e e W
W E e e e W e e e e e e e e W e e e e W
W e W W e W e W W W W W W e W e W W e W
W e W e e e e e e e e e e e e e e W e W
W e W e W W e W W W W W W e W W e W e W
W e e e e e e W G G G G W e e e e e e W
W e W e W W e W W e e W W e W W e W e W
W e W e e e e e e e e e e e e e e W e W
W e W W e W e W W W W W W e W e W W e W
W P e e e W e e e e e e e e W e e e E W
W W W W W W W W W W W W W W W W W W W W
