W W W W W W W W W W W W W W W W W W W W
W E e e e W e e e e e e e e W e e e e W
W e W W e W e W W W W W W e W e W W e W
W e W e e e e e e A e B e e e e e W e W
W e W e W W e W W . . W W e W W e W e W
W e e e e e e W C . . . W e e e e e e W
W e W e W W e W W W W W W e W W e W e W
W e W e e e e e e e e e e e e e e W e W
W e W W e W e W W W W W W e W e W W e W
W e e e e W e e e D . . . P W e e e E W
W e e W W W W W e e e e W W W W W e e W
W E e e e W p . . . a e e e W e e e e W
W e W W e W e W W W W W W e W e W W e W
W e W e e e e e e e e e e e e e e W e W
W e W e W W e W W W W W W e W W e W e W
W e e e e e e W . . . b W e e e e e e W
W e W e W W e W W . . W W e W W e W e W
W e W e e e e e c e d e e e e e e W e W
W e W W e W e W W W W W W e W e W W e W
W e e e e W e e e e e e e e W e e e E W
W W W W W W W W W W W W W W W W W W W W
